R 1080    720
   
NO textures/wall1.xpm
SO textures/wall2.xpm
WE textures/wall3.xpm
EA textures/wall4.xpm

S textures/sprite.xpm

C 150, 80, 80

F 10, 10, 100

    111111111111111111
    100000000000000001
    10000000000000000011
    100000000N000001111
  11100000000000000011111
1111100000002200000011111
   1111100000000001111
11110011000000001111111111
111111110000000011111
1111111100000000000011111
      11000000111000001
      11111111111111111
