R 1080 720
   
NO textures/wall1.xpm
SO textures/wall2.xpm
WE textures/wall3.xpm
EA textures/wall4.xpm

S textures/sprite.xpm

F 50, 10, 100
C 150 ,10,80

1111111111
1111100201
1002000001
1001000N01
1111111111
0000000000