R 1080    720
   
NO textures/wall1.xpm
SO textures/wall2.xpm
WE textures/wall3.xpm
EA textures/wall4.xpm

S textures/sprite.xpm

C 150 ,80,80

F 10 , 10 , 100

1111111111
111111N001
1002000001
1001000001
1111111111
